1111111111111
100C000000001
10100P0111101
100111E000001
1111111111111